F 122,122,122    
R     1080  720 
SO ./source/textures/WALL22.xpm 


NO    ./source/textures/WALL1.xpm  

EA ./source/textures/WALL36.xpm 

WE      ./source/textures/WALL68.xpm
C  255,200,160
S ./source/textures/pillar.xpm

     1111111111
     1111100001
     1000020201
111111002220201
 100000000000001
102000000200001
10000N000200021
100022020220001
100022020020001
100020000000001
100022202200001
111111111111111
